nearest	Distance_Reference
Nearest	Distance_Reference
cheapest	Price_Reference
Cheapest	Price_Reference
lot	Parking_Type
Lot	Parking_Type
closest	Distance_Reference
Closest	Distance_Reference
hnl	Location
Hnl	Location
street	Parking_Type
Street	Parking_Type
valet	Parking_Type
Valet	Parking_Type
least	Price_Reference
Least	Price_Reference
expensive	Price_Reference
Expensive	Price_Reference
garage	Parking_Type
Garage	Parking_Type
destination	Location_Reference
Destination	Location_Reference
free	Price_Reference
Free	Price_Reference
here	Location_Reference
Here	Location_Reference
nearby	Location_Reference
Nearby	Location_Reference
ramp	Parking_Type
Ramp	Parking_Type
restaurant	Location
Restaurant	Location
stadium	Location
Stadium	Location
noon	Calendarx
Noon	Calendarx
inexpensive	Price_Reference
Inexpensive	Price_Reference
lowest	Price_Reference
Lowest	Price_Reference
bob	Location
Bob	Location
grand	Location
Grand	Location
rapids	Location
Rapids	Location
lasting	Calendarx
Lasting	Calendarx
until	Calendarx
Until	Calendarx
lots	Parking_Type
Lots	Parking_Type
mile	Distance_Unit
Mile	Distance_Unit
cheap	Price_Reference
Cheap	Price_Reference
area	Location_Reference
Area	Location_Reference
tonight	Calendarx
Tonight	Calendarx
super duper burger	Location
Super Duper Burger	Location
marina	Location
Marina	Location
sf	Location
SF	Location
miles	Distance_Unit
Miles	Distance_Unit
block	Distance_Unit
Block	Distance_Unit
current	Location_Reference
Current	Location_Reference
location	Location_Reference
Location	Location_Reference
airport	Location
Airport	Location
great	Location
Great	Location
american	Location
American	Location
ballpark	Location
Ballpark	Location
port	Location
Port	Location
going	Location_Reference
Going	Location_Reference
school	Location
School	Location
metered	Parking_Type
Metered	Parking_Type
theater	Location
Theater	Location
hours	Duration
Hours	Duration
riverside	Location
Riverside	Location
dallas	Location
Dallas	Location
times	Location
Times	Location
square	Location
Square	Location
mall	Location
Mall	Location
after	Calendarx
After	Calendarx
town	Location
Town	Location
near	Location_Reference
Near	Location_Reference
football	Location
Football	Location
game	Location
Game	Location
mission	Location
Mission	Location
district	Location
District	Location
georgia	Location
Georgia	Location
dome	Location
Dome	Location
aquarium	Location
Aquarium	Location
building	Location_Reference
Building	Location_Reference
at	Calendarx
At	Calendarx
chipotle	Location
Chipotle	Location
midnight	Calendarx
Midnight	Calendarx
civic	Location
Civic	Location
center	Location
Center	Location
all	Duration
All	Duration
day	Duration
Day	Duration
oakland	Location
Oakland	Location
colisuem	Location
Colisuem	Location
reservation	Parking_Type
Reservation	Parking_Type
harbor	Location
Harbor	Location
yard	Location
Yard	Location
film	Location
Film	Location
on	Calendarx
On	Calendarx
dusk	Calendarx
Dusk	Calendarx
prudential	Location
Prudential	Location
three	Calendarx
Three	Calendarx
applebees	Location
Applebees	Location
white	Location
White	Location
house	Location
House	Location
statue	Location
Statue	Location
liberty	Location
Liberty	Location
thursday	Calendarx
Thursday	Calendarx
morning	Calendarx
Morning	Calendarx
club	Location
Club	Location
wilson	Location
Wilson	Location
hospital	Location
Hospital	Location
jfk	Location
Jfk	Location
downtown	Location
Downtown	Location
ward	Location
Ward	Location
tampa	Location
Tampa	Location
corpus	Location
Corpus	Location
christi	Location
Christi	Location
international	Location
International	Location
burbank	Location
Burbank	Location
japanese	Location
Japanese	Location
friendship	Location
Friendship	Location
garden	Location
Garden	Location
san	Location
San	Location
jose	Location
Jose	Location
meter	Parking_Type
Meter	Parking_Type
tenderloin	Location
Tenderloin	Location
night	Calendarx
Night	Calendarx
best	Price_Reference
Best	Price_Reference
deal	Price_Reference
Deal	Price_Reference
las	Location
Las	Location
olas	Location
Olas	Location
usher	Location
Usher	Location
concert	Location
Concert	Location
work	Location_Reference
Work	Location_Reference
bucks	Amount
Bucks	Amount
starbucks	Location
Starbucks	Location
6th	Location
6Th	Location
avenue	Location
Avenue	Location
rate	Price_Reference
Rate	Price_Reference
speedway	Location
Speedway	Location
fondue	Location
Fondue	Location
lake	Location
Lake	Location
alinea	Location
Alinea	Location
manns	Location
Manns	Location
chinese	Location
Chinese	Location
theatre	Location
Theatre	Location
manhattan	Location
Manhattan	Location
kings	Location
Kings	Location
dominion	Location
Dominion	Location
venue	Location
Venue	Location
oriole	Location
Oriole	Location
camden	Location
Camden	Location
yards	Location
Yards	Location
baltimore	Location
Baltimore	Location
maryland	Location
Maryland	Location
seatac	Location
Seatac	Location
capital	Location
Capital	Location
hill	Location
Hill	Location
garages	Parking_Type
Garages	Parking_Type
hancock	Location
Hancock	Location
hotel	Location
Hotel	Location
today	Calendarx
Today	Calendarx
peachstreet	Location
Peachstreet	Location
boulevard	Location
Boulevard	Location
Reserve	Parking_Type
Reserve	Parking_Type
meters	Parking_Type
Meters	Parking_Type
restaurants	Location
Restaurants	Location
lower	Location
Lower	Location
east	Location
East	Location
side	Location
Side	Location
cleveland	Location
Cleveland	Location
four	Duration
Four	Duration
gulf	Location
Gulf	Location
state	Location
State	Location
roanoke	Location
Roanoke	Location
blocks	Distance_Unit
Blocks	Distance_Unit
malone	Location
Malone	Location
performing	Location
Performing	Location
arts	Location
Arts	Location
unc	Location
Unc	Location
campus	Location
Campus	Location
before	Calendarx
Before	Calendarx
rates	Price_Reference
Rates	Price_Reference
oklahoma	Location
Oklahoma	Location
university	Location
University	Location
afternoon	Calendarx
Afternoon	Calendarx
yankee	Location
Yankee	Location
grant	Location
Grant	Location
highest	Price_Reference
Highest	Price_Reference
pavilions	Location
Pavilions	Location
diner	Location
Diner	Location
needle	Location
Needle	Location
seattle	Location
Seattle	Location
amtrak	Location
Amtrak	Location
train	Location
Train	Location
station	Location
Station	Location
per	Price_Reference
Per	Price_Reference
walking	Distance_Reference
Walking	Distance_Reference
distance	Distance_Reference
Distance	Distance_Reference
blacksburg	Location
Blacksburg	Location
clinic	Location
Clinic	Location
elm	Location
Elm	Location
g	Location
G	Location
redmond	Location
Redmond	Location
reserved	Parking_Type
Reserved	Parking_Type
union	Location
Union	Location
off	Parking_Type
Off	Parking_Type
ramada	Location
Ramada	Location
arena	Location
Arena	Location
neighborhood	Location_Reference
Neighborhood	Location_Reference
columbia	Location
Columbia	Location
saturday	Calendarx
Saturday	Calendarx
mornings	Calendarx
Mornings	Calendarx
venues	Location
Venues	Location
th	Location
Th	Location
spruce	Location
Spruce	Location
academy	Location
Academy	Location
music	Location
Music	Location
city	Location
City	Location
half	Distance_Number
Half	Distance_Number
memorial	Location
Memorial	Location
freeloaders	Location
Freeloaders	Location
bar	Location
Bar	Location
walmart	Location
Walmart	Location
paying	Price_Reference
Paying	Price_Reference
zoo	Location
Zoo	Location
airpot	Location
Airpot	Location
feet	Distance_Unit
Feet	Distance_Unit
library	Location
Library	Location
wayne	Location
Wayne	Location
structure	Parking_Type
Structure	Parking_Type
drs	Location
Drs	Location
office	Location
Office	Location
national	Location
National	Location
rivoli	Location
Rivoli	Location
or	Duration
Or	Duration
more	Duration
More	Duration
hour	Price_Reference
Hour	Price_Reference
bank	Location
Bank	Location
interstate	Location
Interstate	Location
corner	Location
Corner	Location
main	Location
Main	Location
4th	Location
4Th	Location
ave	Location
Ave	Location
basketball	Location
Basketball	Location
courts	Location
Courts	Location
santa	Location
Santa	Location
monica	Location
Monica	Location
pier	Location
Pier	Location
colaba	Location
Colaba	Location
railway	Location
Railway	Location
guggenheim	Location
Guggenheim	Location
kroger	Location
Kroger	Location
price	Price_Reference
Price	Price_Reference
ohare	Location
Ohare	Location
uptown	Location
Uptown	Location
subway	Location
Subway	Location
stop	Location
Stop	Location
st	Location
St	Location
economic	Price_Reference
Economic	Price_Reference
jia	Location
Jia	Location
close	Location_Reference
Close	Location_Reference
possible	Distance_Reference
Possible	Distance_Reference
olive	Location
Olive	Location
sea	Location
Sea	Location
world	Location
World	Location
utica	Location
Utica	Location
madison	Location
Madison	Location
dinner	Calendarx
Dinner	Calendarx
time	Calendarx
Time	Calendarx
johns	Location
Johns	Location
dance	Location
Dance	Location
studio	Location
Studio	Location
business	Location
Business	Location
central	Location
Central	Location
charlotte	Location
Charlotte	Location
til	Calendarx
Til	Calendarx
west	Location
West	Location
hollywood	Location
Hollywood	Location
home	Location_Reference
Home	Location_Reference
runyon	Location
Runyon	Location
canyon	Location
Canyon	Location
lax	Location
Lax	Location
anita	Location
Anita	Location
whiteside	Location
Whiteside	Location
position	Location_Reference
Position	Location_Reference
hall	Location
Hall	Location
beach	Location
Beach	Location
fro	Location
Fro	Location
waikiki	Location
Waikiki	Location
hartfield	Location
Hartfield	Location
levi	Location
Levi	Location
high	Location
High	Location
south	Location
South	Location
amboy	Location
Amboy	Location
boston	Location
Boston	Location
rave	Location
Rave	Location
milwaukee	Location
Milwaukee	Location
safeway	Location
Safeway	Location
valley	Location
Valley	Location
small	Location
Small	Location
administration	Location
Administration	Location
legendary	Location
Legendary	Location
doughnuts	Location
Doughnuts	Location
carolina	Location
Carolina	Location
scoops	Location
Scoops	Location
9th	Location
9Th	Location
halleberton	Location
Halleberton	Location
pittsburgh	Location
Pittsburgh	Location
convention	Location
Convention	Location
minutes	Distance_Unit
Minutes	Distance_Unit
fillmore	Location
Fillmore	Location
stylist	Location
Stylist	Location
minute	Distance_Unit
Minute	Distance_Unit
walk	Distance_Unit
Walk	Distance_Unit
around	Location_Reference
Around	Location_Reference
fairgrounds	Location
Fairgrounds	Location
store	Location
Store	Location
onstreet	Parking_Type
Onstreet	Parking_Type
shedd	Location
Shedd	Location
detroit	Location
Detroit	Location
air	Location
Air	Location
berkeley	Location
Berkeley	Location
during	Calendarx
During	Calendarx
marquette	Location
Marquette	Location
izod	Location
Izod	Location
benedum	Location
Benedum	Location
matador	Location
Matador	Location
door	Location
Door	Location
sports	Location
Sports	Location
complex	Location
Complex	Location
movie	Location
Movie	Location
ami	Location
Ami	Location
castro	Location
Castro	Location
now	Calendarx
Now	Calendarx
art	Location
Art	Location
crabtree	Location
Crabtree	Location
tacoma	Location
Tacoma	Location
general	Location
General	Location
oakdale	Location
Oakdale	Location
binghamton	Location
Binghamton	Location
um	Location
Um	Location
herman	Location
Herman	Location
fortuna	Location
Fortuna	Location
pats	Location
Pats	Location
sons	Location
Sons	Location
transfer	Location
Transfer	Location
cole	Location
Cole	Location
tech	Location
Tech	Location
eagen	Location
Eagen	Location
down	Location
Down	Location
aero	Location
Aero	Location
cafe	Location
Cafe	Location
dania	Location
Dania	Location
taco	Location
Taco	Location
bell	Location
Bell	Location
capitol	Location
Capitol	Location
dianos	Location
Dianos	Location
greenville	Location
Greenville	Location
nc	Location
Nc	Location
mcdonalds	Location
Mcdonalds	Location
shop	Location
Shop	Location
navy	Location
Navy	Location
lincoln	Location
Lincoln	Location
el	Location
El	Location
bike	Location
Bike	Location
rack	Location
Rack	Location
newark	Location
Newark	Location
apartment	Location_Reference
Apartment	Location_Reference
macys	Location
Macys	Location
pine	Location
Pine	Location
salon	Location
Salon	Location
sears	Location
Sears	Location
tower	Location
Tower	Location
church	Location
Church	Location
healthcare	Location
Healthcare	Location
priced	Price_Reference
Priced	Price_Reference
59th	Location
59Th	Location
amsterdam	Location
Amsterdam	Location
sacramento	Location
Sacramento	Location
evening	Calendarx
Evening	Calendarx
baxter	Location
Baxter	Location
nordstroms	Location
Nordstroms	Location
tricounty	Location
Tricounty	Location
ballfield	Location
Ballfield	Location
drive	Distance_Unit
Drive	Distance_Unit
ristorante	Location
Ristorante	Location
del	Location
Del	Location
rio	Location
Rio	Location
collusium	Location
Collusium	Location
gringos	Location
Gringos	Location
merchandise	Location
Merchandise	Location
mart	Location
Mart	Location
louis	Location
Louis	Location
george	Location
George	Location
courthouse	Location
Courthouse	Location
dustman	Location
Dustman	Location
lane	Location
Lane	Location
turner	Location
Turner	Location
field	Location
Field	Location
thirty	Amount
Thirty	Amount
att	Location
Att	Location
mins	Distance_Unit
Mins	Distance_Unit
logan	Location
Logan	Location
metro	Location
Metro	Location
km	Distance_Unit
Km	Distance_Unit
johnny	Location
Johnny	Location
garlics	Location
Garlics	Location
hallandale	Location
Hallandale	Location
airlines	Location
Airlines	Location
dolphin	Location
Dolphin	Location
blvd	Location
Blvd	Location
hersheys	Location
Hersheys	Location
chocolate	Location
Chocolate	Location
hershey	Location
Hershey	Location
eugene	Location
Eugene	Location
hard	Location
Hard	Location
rock	Location
Rock	Location
patio	Location
Patio	Location
eatery	Location
Eatery	Location
honolulu	Location
Honolulu	Location
giants	Location
Giants	Location
tacos	Location
Tacos	Location
jalisco	Location
Jalisco	Location
terminal	Location
Terminal	Location
delores	Location
Delores	Location
spring	Location
Spring	Location
law	Location
Law	Location
firm	Location
Firm	Location
affordable	Price_Reference
Affordable	Price_Reference
chinatown	Location
Chinatown	Location
aventura	Location
Aventura	Location
buy	Location
Buy	Location
sawgrass	Location
Sawgrass	Location
blv	Location
Blv	Location
disneyland	Location
Disneyland	Location
cost	Price_Reference
Cost	Price_Reference
carilion	Location
Carilion	Location
orioles	Location
Orioles	Location
lowes	Location
Lowes	Location
coliseum	Location
Coliseum	Location
stanley	Location
Stanley	Location
hilton	Location
Hilton	Location
hawaiian	Location
Hawaiian	Location
village	Location
Village	Location
shuttle	Location
Shuttle	Location
7th	Location
7Th	Location
tuesday	Calendarx
Tuesday	Calendarx
cinebowl	Location
Cinebowl	Location
whiskey	Location
Whiskey	Location
tango	Location
Tango	Location
week	Duration
Week	Duration
through	Calendarx
Through	Calendarx
beverly	Location
Beverly	Location
shreveport	Location
Shreveport	Location
ritz	Location
Ritz	Location
walkable	Distance_Reference
Walkable	Distance_Reference
medical	Location
Medical	Location
short	Distance_Reference
Short	Distance_Reference
hobby	Location
Hobby	Location
opera	Location
Opera	Location
food	Location
Food	Location
court	Location
Court	Location
book	Parking_Type
Book	Parking_Type
public	Location
Public	Location
couple	Distance_Number
Couple	Distance_Number
supermarket	Location
Supermarket	Location
tamucc	Location
Tamucc	Location
marker	Location
Marker	Location
charge	Price_Reference
Charge	Price_Reference
fairview	Location
Fairview	Location
stars	Location
Stars	Location
doors	Location
Doors	Location
inexpensively	Price_Reference
Inexpensively	Price_Reference
ma	Location
Ma	Location
chez	Location
Chez	Location
atlanta	Location
Atlanta	Location
tomorrow	Calendarx
Tomorrow	Calendarx
onward	Calendarx
Onward	Calendarx
york	Location
York	Location
